111111111111111111111111111111111111111
10010000000C0010000000C0010000000C00001
100001111100000111110000001111100000011
100011000000110000001100000011000000111
10010000010000000C0010000000C0010000001
100001111100101111100111110011111001111
1P0011E00000000000000000000000000000001
10010000000C0010000000C0010000000C00001
100001111100000111110000001111100000011
100011000000110000001100000011000000111
10010000010000000C0010000000C0010000001
100001111100101111100111110011111001111
100011000000000000000000000000000000001
111111111111111111111111111111111111111